11111111111111111111
1000E00C000000000001
10101001000000010101
10101001000000010101
10101001000000010101
10101001000000010101
10101001000000010101
10101001000000010101
10101001000000010101
10101001000000010101
10101001000000010101
10101001000000010101
10101001000000010101
10101001000000010101
10101001000000010101
10101001000000010101
10101001000000010101
10101001000000010101
1P0000000C00C00000C1
11111111111111111111
