111111111111
101010100001
101010100011
101010101011
101000001011
101000001011
101000001011
101000001011
100000000011
110010000E11
10P00C00C001
111111111111
