11111111111111111111
1000E00C000000000001
10101001000000010101
10101001000000010101
10101001000000010101
10101001000000010101
10101001000000010101
10101001000000010101
10101001000000010101
10101001000000010101
10101001000000010101
10101001000000010101
10101001000000010101
10101001000000010101
10101001000000010101
10101001000000010101
10101001000000010101
10101001000000010101
10101001000000010101
10101001000000010101
10101001000000010101
10101001000000010101
10101001000000010101
10101001000000010101
10101001000000010101
10101001000000010101
10101001000000010101
10101001000000010101
10101001000000010101
10101001000000010101
10101001000000010101
10101001000000010101
10101001000000010101
10101001000000010101
10101001000000P10101
10101001000000010101
10000000000000010101
10101000000000010101
10101000000000010101
11111111111111111111
