1111111111111111111111111111111111
1000001E0000000C00000C000000000001
1010011110100000101001000000010101
1010010010101010001001000000010111
100000000C00C00000000000000000P1C1
1111111111111111111111111111111111
