1111111111111111111111111111111111
1000001E0000000C00000C000000000001
1010011110100000101001000000010101
1111010010101010001001000000010001
1P1000000C00C0000000000000000000C1
1111111111111111111111111111111111
