111111
1E0001
101001
101001
1P0001
111111
1
